111111111111111
1P10C0100000001
101010101110111
101010101C00011
10C0100010010E1
111111111111111